8 7
WWWWWWW
W.....W
W.GBG.W
W.BGB.W
W.GBG.W
W.BGB.W
W..K..W
WWWWWWW

6 9
WWWWWWWWW
WWW..WWWW
W.......W
WKB***G.W
W.......W
WWWWWWWWW
    
10 7
WWWWWWW
WWW..WW
WWG.BWW
WWGB.WW
WWGB.WW
WWGB.WW
WWG.BWW
WW...KW
WWW...W
WWWWWWW

8 12
WWWWWWWWWWWW
WWWWWWW....W
WWWWWWW.G..W
WWW..WWWG..W
W.B..B..G.WW
W.KBB.W.G.WW
WW....WWWWWW
WWWWWWWWWWWW

9 13
WWWWWWWWWWWWW
W..........WW
W.WWWWWWW.KWW
W.W.........W
W.W..B...W..W
W.BB.WWWWW..W
WWW..W.W.GGGW
WWWWWW.W....W
WWWWWWWWWWWWW

6 13
WWWWWWWWWWWWW
WWWW....WW..W
W..BBBGGGGBKW
W......WWW..W
W...WWWW.WWWW
WWWWWWWWWWWWW
 
9 10
WWWWWWWWWW
WW....WWWW
W...B.WWWW
W..BB.WWWW
WWW.GWWWWW
WWWWGW.K.W
WWWWG..B.W
WWWWG.WWWW
WWWWWWWWWW
 
9 9
WWWWWWWWW
WWW....WW
WWW..B.WW
WWWWWB.WW
WW.B.B.WW
WGGGGW.WW
W.....K.W
WW..W...W
WWWWWWWWW

14 9
WWWWWWWWW
WWWWKWWWW
WWWWBWWWW
WW..G..WW
W..W.W..W
W.W...W.W
W.W...W.W
W.W...W.W
W..W.W..W
WW.B.B.WW
WWWG.GWWW
WWW...WWW
WWW...WWW
WWWWWWWWW

10 15
WWWWWWWWWWWWWWW
WWWWWW.WWWWWWWW
W.....W....WWWW
WGWW..WBWW..WWW
W...W.....W..WW
WB..W.WWW..W..W
W.W......W..W.W
W.W.WWWW..W.W.W
WG.K....B.*.G.W
WWWWWWWWWWWWWWW
